#####################################################################################################
#S  #       #     # #         # #         # #     # #   #   # # #           #   #   # #       # # # #
### ##### # # ### # ##### # ### ### ####### # ##### ### # # # # # # ######### ### ### # ##### # # # #
#     #   #   #     #     #     #             #       # # #     # #       # #   # #   # #     # #   #
##### # ######### ########### ####### # ### # ##### # # ####### ### # ### # ### # ### ##### # # # # #
#   # # # #     #   #   #   # #   #   #   # # # #   #   #         # # #     #   # #   #     # # # # #
### # # # # # ######### # ### # ##### ##### # # ####### ####### # ### # # ##### # # # ### ##### # ###
#           #     # #   #         #     #   # #   # #   #   #   # #   # # #       # # #     #   #   #
########### ##### # # ##### ########### ### # # # # ### ### ##### # # ### # # # # # ### ##### ### ###
#         #   #   #   #     #       # # #   #   # #       #     #   # #   # # # # #         # #   # #
# ### ### # # ##### ### ### # ##### # ### ##### ### ####### ### # # # ### ### # # ##### ##### # # # #
#   # # #   # #   # # #   # #     # #       # # #     #   #   #   # # #       # # #   # #   #   #   #
# # ### # # ### ### # ### # ### # ######### # ##### ### # ############### ####### ### # ### ### ### #
# # # #   # #     # #   # #   # #     # #       #     # # #   #     #   #       # #       # #   # # #
# ### # ### ### # # # ####### ### # ### # # ### ##### # ##### ### ##### ### ########### ### # ### # #
# #   #   #   # # #     # # # # # #   #   # # #         # # # # # #         #     # #   #   #     # #
### # # ### ### # # ##### # # # ##### ####### # ### # ### # # # # ### ####### ### # # ### ### # # ###
#   #     #     #       #       #     #           # # #   # #     #   #     #   #       # #   # # # #
# # ##### ####### # ####### ######### ### # # ### ### # # # ##### ### # ### # ##### ### # ### # ### #
# # # #   #     # #     # # # # # # #     # # #     # # #   #     # # # #     #   # #   #   # # #   #
##### # ####### ####### # # # # # # # ############# # # # # ### # # # # ### ### # ##### # # # ### # #
# #             #     #   # # #   # # #   #     #   #   # # #   #         #     # #       # #   # # #
# # # ### ### ### ##### ### # # ### # ### # # ##### ### ##### ### ### # ### ### ### # ### # ### # ###
#   # #     #     # # #   #     # # # #   # #     # #   #   # # #   # #   # #     # # # # # #     # #
# ####### ####### # # # ### # # # # # # ####### ##### ##### # # ####### ####### # ##### ######### # #
#   #   # #         #       # #   #       #     #   # # #   #     #   #   # #   #   #   #   #       #
# # # ### ####### ######### ############# # ### ### # # # ##### # # # ##### ##### ### ### # ##### ###
# #     # #       #   # #     # #   # # # # # # #     #       # # # #       # #         # #       # #
### # # ### ####### ### ### ### # # # # # ### # # # ### # # ##### # ### ##### # ####### ##### # ### #
#   # #   # # #   #               #   #   #       #   # # #     # #   #     #   #   #     # # #     #
##### ### # # # ##### # # ### # ### ### ########### ### ##### # # # ### ##### # ### # ##### # #######
#       # # #     #   # # #   # #             #   #   # # #   #   # # # #   # # #       #   # #     #
####### # ### ############# # # ### ############# # # ### # # # # # # # # # ### ### # # # # # ### ###
# # #   #       #   #       # # # # #   #   #   # # #     # # # #   # #   # #   #   # # # # #   #   #
# # # # ##### ### ############# # ##### # ### ### # # # ######### ### ######### ######### # ### # ###
# # # #     #     # #       # # # #   #             # # #     # # # #   #       # #   #   #   #     #
# # ##### # ### # # # ### ### ### # # ### ##### ########### # # # # ### # ##### # # # ### # ### ### #
#       # # #   #       # # #     # # # # #     #       # # # #     #     # #   #   #     #       # #
##### # ### # # # # ####### ### ### ### ####### # ##### # # # ### ### ### # ####### ### ######### ###
#   # #     # # # #   #     # #             #       # # #   #       #   #         #   # # # # # #   #
### ### ### ### ######### # # ##### ### ############# # # ######### ############### ##### # # # ### #
#       # # #     #     # # #   # # #   #   #     #   # #     #             #       #         # #   #
### ##### ##### ##### ### ### ### ##### # # # ### # # # ##### ##### # # ### # ####### ### # ### ### #
#     # #     #       # #   # # #       # #   #     #   #       #   # #   # #   #     # # # #       #
##### # # # # # # ### # # # # # ### ### # # ### ### # # ################# ##### ####### # ####### # #
# #     # # # # #   # #   #   # # #   # # # #     # # # #     # #           #             # #   # # #
# # # ### # ### # # ##### ### # # ### ### # ##### ### ### # ### ##### ####### # ### # ##### # ##### #
#   #   # #     # # # #     # # #     #   # #       #     #     #       #     #   # #       #       #
##### # ##### ### ### ### ### # # ### ### ### # ##################### # # # ####### ##### ##### # ###
#     # # # #   #   # #     #       #     # # # # #       # #   # #   # # # # #   # # # #   # # #   #
# # ### # # # ### ### ### ### ############# # # # # ####### # # # # ##### ### # ### # # ### # # ### #
# #   #     #   #   #     # # # #   #         #     #   # #   #     #     # #       #       #   # # #
### # # # ############### # # # # ### ##### ##### ### # # ### # # ### # ### ##### ############### # #
#   # # #     # #   #   #   # # # #   # #     #       # # # # # #   # #   #     # #   #   #         #
# ####### ### # ### # ####### # # # ### ### ############# # ### ### # ### # ### ### # ### # #########
#   #     #   #       #     # #   #   # #   # #   #   #   #   #   #     #     #   # # #           # #
# ##### ##### ##### ### ### ### ##### # ### # ### # ##### ### # # ######### # ### # ##### # # ##### #
#     # #       # # #     # #   #       #   # #   #             # # # #     # #         # # # # #   #
# ### ##### # ### # ### ### # # # ##### ##### # # ####### ####### # # ### ############### ### # # ###
#   #     # # # #   #     #   #   #     #   #   # # #       #         #   #   #   # # #   #     #   #
# ### # ####### # ##################### ### # ##### # ### ##### ######### ### # ### # ##### # ### # #
#   # # #   #   # # # #       #     # #     #       #   # #     # #   # # # #             # # #   # #
######### ##### # # # # ### ### # # # ### ### ### # # ####### ### # ### ### # ### ############# # # #
#   #   #   #         # #   #   # # # #   #     # # # # #   #     #   #       #   #         # # # # #
# ### # # # ### ### # # ######### ### # # ######### ### # ### ##### ### ### # # ### ### # # # ### ###
#     # # #   # #   # # # # #   #     # #   #         #         #   #   #   # #   # #   # #     # # #
# ### ### ### ### # ### # # # ### # ##### ##### ##### ### # ### # ### # # # ######### ####### # # # #
# # #       # #   # #   #   #     #       # # # #   # #   # # #       # # #     # #   #   #   #   # #
### # # # ####### ##### ### # ### ##### # # # # # ##### ##### ######### ####### # ####### ####### # #
#   # # #   #     # #   #     # # #     #     #       # # #     #     # #         #   # #     # #   #
### # ### ### ##### ### ##### # # # ### ##### ### # ### # # # ####### # # # ##### ### # # ##### # # #
#       #       #       # #     # # #       #     #         # #       # # #   #           # #     # #
######### ##### ### ### # # ##### # ##### ########### # ### ### # ### # # ##### ####### ### # ##### #
# #       #     #   # # #     # # # #   # #     #     #   #     # # # # # # # # # # #         #     #
# # ####### # ### ### ### ### # ### ### # # # # # # ### # ### ##### # ### # # # # # ### ### ####### #
#   #   #   #   #       # # #   #     # # # # # # #   # # # # #     # #   #     #         # #   #   #
# ##### ### ####### # # # # ### # # ### # ### # ##### # # # # # ######### ##### ##### ######### # ###
# #       #       # # # #   # # # # # # #     #   # # # # #   #     # # # #     #       #   # #     #
##### # ### ####### ##### ### # # ### # # ### ##### ##### ##### ### # # ### ##### # ####### # ##### #
#     #           #   #     # # # # # #   #   #         # #       #           #   #   #       #   # #
### # ### # ####### ### ### # ### # # # ### ######### # ##### ##### # # # ####### ### ### ####### ###
# # # #   #       # #     # # #     #     #   # #   # #           # # # #   #     #   #     #   #   #
# ### # ##### # # # # ##### # # ######### # # # # ################# # # ### # ####### # ##### ##### #
#     # #   # # # #       #   # #         # #             # #     # # # #   # #                 #   #
##### ##### ### # ### # # ####### ####### ### ### # ####### # ### ####### ### ##### ### ##### # ### #
#       #       #     # #   # #   #       #   # # #   #   # # #   #     #   #   #     #   # # #     #
# # ##### # ####### ##### ### # # # # ####### # ### # # ### # ### # ##### # ### ########### # # # ###
# #   #   # #       # #   #   # # # #   # #   #     #   #   # # #   #     # #     #   #       # # # #
######### ####### ### ####### ### ####### ### ### ### # # # # # ### # ### ####### ### ### # ##### # #
#   #     #               #             #   # #   #   # # # #   #       # # # #     #     #   # #   #
# ####### ####### ####### ### # # # ### ### # ####### # # ##### ##### ##### # ##### ##### # ### # ###
#   #     #     #   #       # # # # #     # # #   # # #     #     #   # # # # #   # # # # #     #   #
# # # # # ### # ### # ####### # ### ##### # # # # # ####### ### ##### # # # # ### ### # ##### # #####
# # # # #   # #     #     #   # #       # #     #   #   #   #     # # #       # #       #     # #   #
### # ##### ### ##### # ####### ### # ####### ##### # ############# ####### ### # ### # # # ##### ###
#   #   #   #       # # #   # #   # #   #   # # # # #         # #   #               # # # #     # #E#
# # # # ### ######### ### ### ####### ### ### # # ### # # # ### ### ######### # # ##### # # ### # # #
# #   # # # #     #     #     # #         #   #   # # # # #   #       #     # # #   #     # #   # # #
####### # ##### # ##### # ##### ############# # ### # ##### # # ##### # ### # # # # ### # # ### # # #
#             # #                         #               # # # #       #     # # # #   # #   #     #
#####################################################################################################
 
