################################################################################
S                                                                  #          #
################################################################## # ######## #
#                                                          ####### # ##    ## #
# ######################################################## #       # ## ## ## #
# # E                                                    # ####### # ## ## ## #
# # #################################################### #         # ## #  ## #
# #                                                      ######### # ## ## ## #
# ###################################################### # #       # ## ## ## #
# #                                                        # ##### # ## ## ## #
# # ###################################################### # # ### # ## ## ## #
# # #       #########################                      # #     # ## ## ## #
# # # #####                         ######################## ##### # ## ## ## #
# # # ## ########################## # ##     ###     ##    ##    # # ## ## ## #
# # #  #                            #    ###     ###    ##    #### # ## ## ## #
# # ## ############################ # ############################ # ## ## ## #
# # ## #                       ###  #                            # # ## ## ## #
# # ## # ########## ############   ## ############################## ## ## ## #
# #    #          # #            ####                                #  ###   #
# ################# ####### ######### ##############################   #### # #
#                #  #                                            # ########## #
######## ######### ############################################### #          #
#                  #                                                 ### ######
######################