#####################################################################################################
#...#       #     # #         # #         # #     # #   #   # # #           #   #   # #       # # # #
###.##### # # ### # ##### # ### ### ####### # ##### ### # # # # # # ######### ### ### # ##### # # # #
#  ...#   #   #     #     #     #             #       # # #     # #       # #   # #   # #     # #   #
#####.# ######### ########### ####### # ### # ##### # # ####### ### # ### # ### # ### ##### # # # # #
#   #.# # #     #   #   #   # #   #   #   # # # #   #   #         # # #     #   # #   #     # # # # #
### #.# # # # ######### # ### # ##### ##### # # ####### ####### # ### # # ##### # # # ### ##### # ###
#    .......#     # #   #         #     #   # #   # #   #   #   # #   # # #       # # #     #   #   #
###########.##### # # ##### ########### ### # # # # ### ### ##### # # ### # # # # # ### ##### ### ###
#         #.  #   #   #     #       # # #   #   # #       #     #   # #   # # # # #         # #   # #
# ### ### #.# ##### ### ### # ##### # ### ##### ### ####### ### # # # ### ### # # ##### ##### # # # #
#   # # #  .# #   # # #   # #     # #       # # #     #   #   #   # # #       # # #   # #   #   #   #
# # ### # #.### ### # ### # ### # ######### # ##### ### # ############### ####### ### # ### ### ### #
# # # #   #.#  ...# #   # #   # #     # #       #     # # #   #     #   #       # #       # #   # # #
# ### # ###.###.#.# # ####### ### # ### # # ### ##### # ##### ### ##### ### ########### ### # ### # #
# #   #   #.  #.#.#     # # # # # #   #   # # #.......  # # # # # #         #     # #   #   #     # #
### # # ###.###.#.# ##### # # # ##### ####### #.### #.### # # # # ### ####### ### # # ### ### # # ###
#   #     #.....#...    #       #     #  .......  # #.#   # #     #   #     #   #       # #   # # # #
# # ##### ####### #.####### ######### ###.# # ### ###.# # # ##### ### # ### # ##### ### # ### # ### #
# # # #   #     # #.....# # # # # # #.....# # #     #.# #   #     # # # #     #   # #   #   # # #   #
##### # ####### #######.# # # # # # #.############# #.# # # ### # # # # ### ### # ##### # # # ### # #
# #             #     #.  # # #   # #.#   #     #   #...# # #   #         #     # #       # #   # # #
# # # ### ### ### #####.### # # ### #.### # # ##### ###.##### ### ### # ### ### ### # ### # ### # ###
#   # #     #     # # #.  #     # # #.#   # #     # #...#   # # #   # #   # #     # # # # # #     # #
# ####### ####### # # #.### # # # # #.# ####### #####.##### # # ####### ####### # ##### ######### # #
#   #   # #         #  .....# #   #  .....#     #   #.# #   #     #   #   # #   #   #   #   #       #
# # # ### ####### #########.#############.# ### ### #.# # ##### # # # ##### ##### ### ### # ##### ###
# #     # #       #   # #  .  # #...# # #.# # # #  ...#       # # # #       # #         # #       # #
### # # ### ####### ### ###.### #.#.# # #.### # # #.### # # ##### # ### ##### # ####### ##### # ### #
#   # #   # # #   #        .......#.  #...#       #.  # # #     # #   #     #   #   #     # # #     #
##### ### # # # ##### # # ### # ###.###.###########.### ##### # # # ### ##### # ### # ##### # #######
#       # # #     #   # # #   # #  .....      #   #.  # # #   #   # # # #   # # #       #   # #     #
####### # ### ############# # # ### ############# #.# ### # # # # # # # # # ### ### # # # # # ### ###
# # #   #       #   #       # # # # #   #   #   # #.#     # # # #   # #   # #   #   # # # # #   #   #
# # # # ##### ### ############# # ##### # ### ### #.# # ######### ### ######### ######### # ### # ###
# # # #     #     # #       # # # #   #        .....# # #     # # # #   #       # #   #   #   #     #
# # ##### # ### # # # ### ### ### # # ### #####.########### # # # # ### # ##### # # # ### # ### ### #
#       # # #   #       # # #     # # # # #    .#.......# # # #     #     # #   #   #     #       # #
##### # ### # # # # ####### ### ### ### #######.#.#####.# # # ### ### ### # ####### ### ######### ###
#   # #     # # # #   #     # #             #  ...  # #.#   #       #   #         #   # # # # # #   #
### ### ### ### ######### # # ##### ### ############# #.# ######### ############### ##### # # # ### #
#       # # #     #     # # #   # # #   #   #     #...#.#     #             #       #         # #   #
### ##### ##### ##### ### ### ### ##### # # # ### #.#.#.##### ##### # # ### # ####### ### # ### ### #
#     # #     #       # #   # # #       # #   #.....#...#       #   # #   # #   #     # # # #       #
##### # # # # # # ### # # # # # ### ### # # ###.### # # ################# ##### ####### # ####### # #
# #     # # # # #   # #   #   # # #   # # # #  ...# # # #     # #           #             # #   # # #
# # # ### # ### # # ##### ### # # ### ### # #####.### ### # ### ##### ####### # ### # ##### # ##### #
#   #   # #     # # # #     # # #     #   # #.....  #     #     #       #     #   # #       #       #
##### # ##### ### ### ### ### # # ### ### ###.# ##################### # # # ####### ##### ##### # ###
#     # # # #   #   # #     #       #     # #.# # #       # #   # #   # # # # #   # # # #   # # #   #
# # ### # # # ### ### ### ### ############# #.# # # ####### # # # # ##### ### # ### # # ### # # ### #
# #   #     #   #   #     # # # #   #.........#     #   # #   #     #     # #       #       #   # # #
### # # # ############### # # # # ###.##### ##### ### # # ### # # ### # ### ##### ############### # #
#   # # #     # #   #   #   # # # #...# #     #       # # # # # #   # #   #     # #   #   #         #
# ####### ### # ### # ####### # # #.### ### ############# # ### ### # ### # ### ### # ### # #########
#   #     #   #       #     # #   #...# #   # #   #   #   #   #   #     #     #   # # #           # #
# ##### ##### ##### ### ### ### #####.# ### # ### # ##### ### # # ######### # ### # ##### # # ##### #
#     # #       # # #     # #   #    ...#   # #   #             # # # #     # #         # # # # #   #
# ### ##### # ### # ### ### # # # #####.##### # # ####### ####### # # ### ############### ### # # ###
#   #     # # # #   #     #   #   #    .#   #   # # #       #         #   #   #   # # #   #     #   #
# ### # ####### # #####################.### # ##### # ### ##### ######### ### # ### # ##### # ### # #
#   # # #   #   # # # #       #     # #...  #       #   # #     # #   # # # #             # # #   # #
######### ##### # # # # ### ### # # # ###.### ### # # ####### ### # ### ### # ### ############# # # #
#   #   #   #         # #   #   # # # #  .#     # # # # #   #     #   #.....  #   #         # # # # #
# ### # # # ### ### # # ######### ### # #.######### ### # ### ##### ###.###.# # ### ### # # # ### ###
#     # # #   # #   # # # # #   #     # #.  #         #  .......#   #...#  .# #   # #   # #     # # #
# ### ### ### ### # ### # # # ### # #####.##### ##### ###.# ###.# ###.# # #.######### ####### # # # #
# # #       # #   # #   #   #     #      .# # # #   # #...# # #.......# # #.....# #   #   #   #   # #
### # # # ####### ##### ### # ### ##### #.# # # # #####.##### ######### #######.# ####### ####### # #
#   # # #   #     # #   #     # # #     #.....#  ...  #.# #     #     # #      ...#   # #     # #   #
### # ### ### ##### ### ##### # # # ### #####.###.#.###.# # # ####### # # # #####.### # # ##### # # #
#       #       #       # #     # # #       #.....#.....    # #       # # #   #  .......  # #     # #
######### ##### ### ### # # ##### # ##### ########### # ### ### # ### # # ##### #######.### # ##### #
# #       #     #   # # #     # # # #   # #     #     #   #     # # # # # # # # # # #  .      #     #
# # ####### # ### ### ### ### # ### ### # # # # # # ### # ### ##### # ### # # # # # ###.### ####### #
#   #   #   #   #       # # #   #     # # # # # # #   # # # # #     # #   #     #    ...  # #   #   #
# ##### ### ####### # # # # ### # # ### # ### # ##### # # # # # ######### ##### #####.######### # ###
# #       #       # # # #   # # # # # # #     #   # # # # #   #     # # # #     #  ...  #   # #     #
##### # ### ####### ##### ### # # ### # # ### ##### ##### ##### ### # # ### ##### #.####### # ##### #
#     #           #   #     # # # # # #   #   #         # #       #           #   #...#       #   # #
### # ### # ####### ### ### # ### # # # ### ######### # ##### ##### # # # ####### ###.### ####### ###
# # # #   #       # #     # # #     #     #   # #   # #           # # # #   #     #  .#     #   #   #
# ### # ##### # # # # ##### # # ######### # # # # ################# # # ### # #######.# ##### ##### #
#     # #   # # # #       #   # #         # #             # #     # # # #   # #      .........  #   #
##### ##### ### # ### # # ####### ####### ### ### # ####### # ### ####### ### ##### ### #####.# ### #
#       #       #     # #   # #   #       #   # # #   #   # # #   #     #   #   #     #   # #.#     #
# # ##### # ####### ##### ### # # # # ####### # ### # # ### # ### # ##### # ### ########### #.# # ###
# #   #   # #       # #   #   # # # #   # #   #     #   #   # # #   #     # #     #   #    ...# # # #
######### ####### ### ####### ### ####### ### ### ### # # # # # ### # ### ####### ### ### #.##### # #
#   #     #               #             #   # #   #   # # # #   #       # # # #     #     #.  # #   #
# ####### ####### ####### ### # # # ### ### # ####### # # ##### ##### ##### # ##### ##### #.### # ###
#   #     #     #   #       # # # # #     # # #   # # #     #     #   # # # # #   # # # # #...  #   #
# # # # # ### # ### # ####### # ### ##### # # # # # ####### ### ##### # # # # ### ### # #####.# #####
# # # # #   # #     #     #   # #       # #     #   #   #   #     # # #       # #       #  ...# #   #
### # ##### ### ##### # ####### ### # ####### ##### # ############# ####### ### # ### # # #.##### ###
#   #   #   #       # # #   # #   # #   #   # # # # #         # #   #               # # # #.....# #!#
# # # # ### ######### ### ### ####### ### ### # # ### # # # ### ### ######### # # ##### # # ###.# #.#
# #   # # # #     #     #     # #         #   #   # # # # #   #       #     # # #   #     # #  .# #.#
####### # ##### # ##### # ##### ############# # ### # ##### # # ##### # ### # # # # ### # # ###.# #.#
#             # #                         #               # # # #       #     # # # #   # #   #.....#
#####################################################################################################
 
ÿÿÿÿÿÿÿÿÿÿÿÿÿÿÿÿÿÿÿÿÿÿÿÿÿÿÿÿÿÿÿÿÿÿÿÿÿÿÿÿÿÿÿÿÿÿÿÿÿÿÿÿÿÿÿÿÿÿÿÿÿÿÿÿÿÿÿÿÿÿÿÿÿÿÿÿÿÿÿÿÿÿÿÿÿÿÿÿÿÿÿÿÿÿÿÿÿÿÿÿ